["Premier Niveau" : {50,25}]
|                                                  |
|                                                  |
|                                                  |
|                                                  |
|                                                  |
|                                                  |
|                                                  |
|                                                  |
|                            222222222222222222222 |
|                                                  |
|                                                  |
|                11111                             |
|                                                  |
|                                                  |
|                                                  |
|  1111111                                         |
|                                                  |
|                                                  |
|                                                  |
| 111111         111111      1                     |
|                            1             33333333|
|                            1                     |
|                            1                     |
|11111111111111111111111111111111111111111111111111|
|11111111111111111111111111111111111111111111111111|
